23 20

0 1 2 3 4 5 0 0 0 0 0 0  0 0 0 0 0 0 0 0 0 0 0
0 0 0 0 1 1 0 0 0 0 0 0  0 0 o o o 0 0 0 0 0 0
0 0 0 0 1 1 0 0 0 0 0 0  0 0 0 0 0 0 0 0 0 0 0
0 0 0 0 1 1 0 0 0 0 0 0  0 0 0 0 0 0 0 0 0 0 0
0 0 0 0 1 1 0 0 0 0 0 0  0 0 0 0 0 0 0 0 0 0 0
0 0 0 0 1 1 0 0 0 0 0 0  0 0 0 0 0 0 0 0 0 0 0
0 0 0 0 1 1 0 0 0 0 0 0  0 0 0 0 0 0 0 0 0 0 0
0 0 0 0 1 1 0 0 0 0 0 0  0 0 0 0 0 0 0 0 0 0 0
0 0 0 0 1 1 0 0 0 0 0 o  0 0 0 0 0 0 0 0 0 0 0
0 0 0 0 1 1 0 0 t t t t  t t t t 0 0 0 0 0 0 0
0 0 0 0 1 1 0 0 0 0 0 mi 0 0 0 t 0 0 0 0 0 0 0
0 0 0 0 1 1 0 0 0 0 0 0  0 0 0 t 0 0 0 0 0 0 0
0 0 e 0 1 1 0 0 0 0 0 0  0 0 0 0 0 0 0 0 0 0 0
0 0 e 0 0 0 0 0 0 0 0 mc 0 0 0 t 0 0 0 0 0 0 0
0 0 e 0 0 0 0 0 0 t t 0  0 0 0 t 0 0 0 0 0 0 0
0 0 e 0 1 1 0 0 t t g 0  t 0 t t 0 0 0 0 0 0 0
0 0 0 0 1 1 0 0 0 t t 0  p t t 0 0 0 0 0 0 0 0
1 1 1 1 1 1 0 0 0 0 0 0  0 0 0 0 0 0 0 0 0 0 0
1 1 1 0 0 0 0 0 0 o 0 0  0 0 0 0 0 0 0 0 0 0 o
1 1 0 0 o 0 0 0 0 0 0 0  0 0 0 0 0 0 0 0 0 o 0
